1111111111111
10010000000C1
1P0C011111001
1000110C00001
100C010010001
111000C11C0E1
1111111111111