111111111111111111111
11C000000000000111111
10011000000000C011111
100000011011100001111
111000000000C00000111
100001111000000000011
10P000000C00001110C01
111100C00000001000111
10000C1000111000000E1
111111111111111111111