111111111
11P000001
10000C101
110C00001
1C0000101
111100001
11C000001
100C00101
100000101
110000001
111C00C11
111100001
111110E11
111111111