1111111111111
10010000000C1
100C011111001
1P00110C00001
100C010110001
111000C11C0E1
1111111111111