111111111111111111111
11C000000000000111111
10011000000000C011111
100000011011100001111
111000000000C00000111
100001111000000000011
1P0000000C00001100C01
11100C000000010001111
10000C100011100000E11
111111111111111111111